000000000000000000000000000000000000000000
000000000111110000000000000000000000000000
000000111111111111000000000000000000000000
000111111111111111111100000000055544550000
011111111111111111111111103222315555555000
111111111111111111111111111111115555555555
