000000000000000000000000000000000000000000000000000000000000000000000000000000000000000000000000000000000000000000000000000000000000000000000000000
000000060001111100000000001001000000000000111100000000000000000111100000000000000000000000111100000000000000000000000000000111100000000000000000000
000000111111111111110000011441441000001111111111111000044144000111111111111000000414400001111111111111100000000444340000011111111111111000000000000
000011111111111111111111111333331111111111111111111111133333111111111111111111111333331111111111111111111111133333111111111111111111111111111000000
000111111111111111111111111322231111111111111111111111132223111111111111111111111322231111111111111111111111132223111111111111111111111111111111111
001555555555555555555555555555555555555555555555555555555555555555555555555555555555555555555555555555555555555555555555555555555555555555555555555