000000000000000000000000000000000000000000000000000000000000000000000000000000000000000000000000000000000000000000000000000000000000000000000000000000000000000000000000000000000000000000000000000000000000000000000000000000000000000000000000033333
000000000000000000000000000000000000000000000000000000000000000000000000000000000000000000000000000000000000000000000000000000000000000000000000000000000000000000000000000000000000000000000000000000000000000000000000000000000000000000000000033333
000000000000000000000000000000000000000000000000000000000000000000000000000000000000000000000000000000000000000000000000000000000000000000000000000000000000000000000000000000000000000000000000000000000000000000000000000000000000000000000000033333
000000000000000000000000000000000000000000000000000000000000000000000000000000000000000000000000000000000000000000000000000000000000000000000000000000000000000000000000000000000000000000000000000000000000000000000000000000000000000000000000033333
000000000000000000000000000000000000000000000000000000000000000000000000000000000000000333333333333333333333333333333333333333300000000000000000000000000000000000000000000000000000000000000000000000000000001000000000000060000000000000000000033333
000000000000000000000000000000000000000000000000000000000000000000000000000000000000000333333333333333333333333333333333333333300000000000000000000000000000000000000000000000000000000000000000000000006001000010000000000010000000000000000000033333
000000000000000000000000000000000000000000000000000600000000000000000000000000000000000000000000000000000000000000000000000000000000000000000000000000000000000000000000000000000000000000000000000000001000000000010060000110001000000000000000033333
000000000000000000000000000000000000000000000000000000000600000000000000000000000000000000006000000000000000000000000000000000000000000000000000000000000000000000000000000000000000000000000000000001000000100000000100100000000000000000000000033333
000000000060000000600000006000000000000000000000000000555555555550000000000000000000000000000000000000000000000000000006000000000000000000060060060006000610060006000600060006000000000000000000001000000000000100000000000000000001000006000000033333
000000000010000001100000100000000000100000000005555555555555555550500000000000000000000000010000000000006000000000000001000000000000000000010010010001000110010001000100010001000000000000055555555555555555555555554444444455000011100000000007033333
000555555555555555555555554555555500000555555555555555555555555555555555555555555555555555550055555555550055555555555455555555555555555550000000000000000000000000000000000000000555555555555555555555555555555555555555555555555555555555555555533333
005333333333333333333333333333333322222333333333333333333333333333333333333333333333333333334433333333332233333333333333333333333333333332222222222222222222222222222222222222222333333333333333333333333333333333333333333333333333333333333333333333
