00000000000000000000000000000000000000000000000000000000000000000000000000000000000000000000000000000000000000000000000000000000000000000000000000000000000000000000000000000000000000000000000000000000000000000000000000000000000000000000000003
00000000000000000000000000000000000000000000000000000000000000000000000000000000000000000000000000000000000000000000000000000000000000000000000000000000000000000000000000000000000000000000000000000000000000000000000000000000000000000000000003
00000000000000000000000000000000000000000000000000000000000000000000000000000000000000000000000000000000000000000000000000000000000000000000000000000000000000000000000000000000000000000000000000000000000000000000000000000000000000000000000003
00000000000000000000000000000000000000000000000000000000000000000000000000000000000000000000000000000000000000000000000000000000000000000000000000000000000000000000000000000000000000000000000000000000000000000000000000000000000000000000000003
00000000000000000000000000000000000000000000000000000000000000000000000000000000000000033333333333333333333333333333333333333330000000000000000000000000000000000000000000000000000000000000000000000000000000000000000000000000000000000000000003
00000000000000000000000000000000000000000000000000000000000000000000000000000000000000033333333333333333333333333333333333333330000000000000000000000000000000000000000000000000000000000000000000000000600000000000000000000000000000000000000003
00000000000000000000000000000000000000000000000000660000000000000000000000000000000000000000000000000000000000000000000000000000000000000000000000000000000000000000000000000000000000000000000000000000100000000000000000000000000000000000000003
00000000000000000000000000000000000000000000000000000000060000000000000000000000000000000000600000000000000000000000000000000000000000000000000000000000000000000000000000000000000000000000000000000100000010000000666666660000000000000000000003
00000000006000000060000000600000000000000000000000000055555555555000000000000000000000000000000000000000000000000000000600000000000000000006006006000600061006000600060006000600000000000000000000100000000000010000000000000000000000000000000003
00000000001000000110000010000000000010000000000555555555555555555050000000000000000000000001000000000000600000000000000100000000000000000001001001000100011001000100010001000100000000000005555555555555555555555555444444445500000000000000000003
00055555555555555555555555455555550000055555555555555555555555555555555555555555555555555555005555555555005555555555545555555555555555555000000000000000000000000000000000000000055555555555555555555555555555555555555555555555555555555555555553
00533333333333333333333333333333332222233333333333333333333333333333333333333333333333333333443333333333223333333333333333333333333333333222222222222222222222222222222222222222233333333333333333333333333333333333333333333333333333333333333333
